02 02 02 02 02 02 02 02 02 02 02 02 02 02 02 02 02 02 02 02 02 02 02 02 02 
02 02 02 02 02 02 02 02 02 02 02 02 02 02 02 02 02 02 02 02 02 02 02 02 02 
02 02 02 02 02 02 02 02 02 02 02 02 02 02 02 02 02 02 02 02 02 02 02 02 02 
02 02 02 02 02 02 02 02 02 02 02 02 02 02 02 02 02 02 02 02 02 02 02 02 02 
02 02 02 02 02 02 02 02 02 02 02 02 02 02 02 02 02 02 02 02 02 02 02 02 02 
02 02 02 02 02 02 02 02 02 02 02 05 05 05 02 02 02 02 02 02 02 02 02 02 02 
02 02 02 02 02 02 02 02 02 02 04 01 01 01 06 02 02 02 02 02 02 02 02 02 02 
02 02 02 02 02 02 02 02 02 02 04 01 01 01 06 02 02 02 02 02 02 02 02 02 02 
02 02 02 02 02 02 02 02 02 02 04 01 01 01 06 02 02 02 02 02 02 02 02 02 02 
02 02 02 02 02 02 02 02 02 02 04 01 01 01 06 02 02 02 02 02 02 02 02 02 02 
02 02 02 02 02 02 02 02 02 02 04 01 01 01 06 02 02 02 02 02 02 02 02 02 02 
02 02 02 02 02 02 02 02 02 02 04 01 01 01 06 02 02 02 02 02 02 02 02 02 02 
02 02 02 02 02 02 02 02 02 02 04 01 01 01 06 02 02 02 02 02 02 02 02 02 02 
02 02 02 02 02 02 02 02 02 02 04 01 01 01 06 02 02 02 02 02 02 02 02 02 02 
02 02 02 02 02 02 02 02 02 02 04 01 01 01 06 02 02 02 02 02 02 02 02 02 02 
02 02 02 02 02 02 02 02 02 02 04 01 01 01 06 02 02 02 02 02 02 02 02 02 02 
02 02 02 02 02 02 02 02 02 02 02 03 03 03 02 02 02 02 02 02 02 02 02 02 02 
02 02 02 02 02 02 02 02 02 02 02 02 02 02 02 02 02 02 02 02 02 02 02 02 02 
02 02 02 02 02 02 02 02 02 02 02 02 02 02 02 02 02 02 02 02 02 02 02 02 02 
02 02 02 02 02 02 02 02 02 02 02 02 02 02 02 02 02 02 02 02 02 02 02 02 02 
02 02 02 02 02 02 02 02 02 02 02 02 02 02 02 02 02 02 02 02 02 02 02 02 02
02 02 02 02 02 02 02 02 02 02 02 02 02 02 02 02 02 02 02 02 02 02 02 02 02 

