02 02 02 02 02 02 02 02 02 02 02 02 02 02 02 02 02 02 02 02 02 02 02 02 02 
02 02 02 02 02 02 02 02 02 02 02 02 02 02 02 02 02 02 02 02 02 02 02 02 02
02 02 02 02 02 02 02 02 02 02 02 02 02 02 02 02 02 02 02 02 02 02 02 02 02 
02 02 02 02 02 02 02 02 02 02 02 02 02 02 02 02 02 02 02 02 02 02 02 02 02 
02 02 02 02 02 02 02 02 02 02 02 02 02 02 02 02 02 02 02 02 02 02 02 02 02 
02 02 02 02 02 05 05 05 05 05 05 05 05 05 05 05 05 05 05 05 02 02 02 02 02 
02 02 02 02 04 01 01 01 01 01 01 01 01 01 01 01 01 01 01 01 09 02 02 02 02 
02 02 02 02 04 01 01 01 01 01 01 01 01 01 01 01 01 01 01 01 01 06 02 02 02 
02 02 02 02 04 01 01 01 01 01 01 01 01 01 01 01 01 01 01 01 01 06 02 02 02 
02 02 02 02 04 01 01 01 01 01 01 01 01 01 01 01 01 01 01 01 01 06 02 02 02 
02 02 02 02 02 03 03 03 03 03 03 03 03 03 03 03 07 01 01 01 01 06 02 02 02 
02 02 02 02 02 05 05 05 05 05 05 05 05 05 05 05 08 01 01 01 01 06 02 02 02 
02 02 02 02 08 01 01 01 01 01 01 01 01 01 01 01 01 01 01 01 01 06 02 02 02 
02 02 02 04 01 01 01 01 01 01 01 01 01 01 01 01 01 01 01 01 01 06 02 02 02 
02 02 02 04 01 01 01 01 01 01 01 01 01 01 01 01 01 01 01 01 01 06 02 02 02 
02 02 02 02 07 01 01 01 01 01 01 01 01 01 01 01 01 01 01 01 10 02 02 02 02 
02 02 02 02 02 03 03 03 03 03 03 03 03 03 03 03 03 03 03 03 02 02 02 02 02 
02 02 02 02 02 02 02 02 02 02 02 02 02 02 02 02 02 02 02 02 02 02 02 02 02 
02 02 02 02 02 02 02 02 02 02 02 02 02 02 02 02 02 02 02 02 02 02 02 02 02 
02 02 02 02 02 02 02 02 02 02 02 02 02 02 02 02 02 02 02 02 02 02 02 02 02 
02 02 02 02 02 02 02 02 02 02 02 02 02 02 02 02 02 02 02 02 02 02 02 02 02
02 02 02 02 02 02 02 02 02 02 02 02 02 02 02 02 02 02 02 02 02 02 02 02 02
